111111111
100000001
10S000001
100000001
1000N0001
100000001
100000W01
100000001
111111111

