111111111111111111
100000000000000000
100000000000000000
100000000000000000
100000N00000000000
100000000000000000
100000000000000000
111111111111111111
